1111111111111111111111111111111111111111111111111111111111111111111111111111111
1000000000000000000000000000000C10000000010000000000000001000000000001100000001
1000000000000000000000000000000C10000000010000000000000001000000000001100000001
1000000000000000000000000000000100000000100000000000000010000000000011000000011
1000000000000000000000000000000C10000000010000000000000001000000000000000000001
1000000000000010000000000000000000000000101000000000000010000000000011000000011
1000000000000000000000000000000C10000000010100000000000001000000000001100000001
10000000000000010000000000000001000000001010000000C0000000000000000011000000111
1000000000000000000000000000000C10000000010100000000000001000000000001100000E01
1000000000000010000000000000000010000000000000000000000001000000000001000000111
10000000000000100000000000000000C1000000000000000000000000100000000001100000001
10000000000000100000000P00000000C1000000000000000000000000100000000001100000001
10000000000000100000000000000000100000000000010000C0000001000000000011000000011
10000000000000100000000000000000C1000000000000000000000000100000000001100000001
1111111111111111111111111111111111111111111111111111111111111111111111111111111
