11111111111111111111
10000000010000000001
1000000001000C000001
10000000E1000000P001
11111111010111111111
11111111111111111111
