1111111111111111111111
100000000000000001C001
1P000000000111C0000001
100000000C000000111111
1C000000000111000000E1
1111111111111111111111
